{
  "name": "Sample Map",
  "tileSetId": 0,
  "rooms": [
    {
      "tiles": [
        [
          58, 58, 58, 58, 58, 58, 58, 58, 58, 58,
          58, 58, 58, 58, 58, 58, 58, 58, 58, 58,
          58, 58, 58, 58, 58, 58, 58, 58, 58, 58,
          58, 58, 58, 58, 58, 58, 58, 58, 58, 58,
          58, 58, 58, 58, 58, 58, 58, 58, 58, 58,
          58, 58, 58, 58, 58, 58, 58, 58, 58, 58,
          58, 58, 58, 58, 58, 58, 58, 58, 58, 58,
          58, 58, 58, 58, 58, 58, 58, 58, 58, 58,
          58, 58, 58, 58, 58, 58, 58, 58, 58, 58,
          58, 58, 58, 58, 58, 58, 58, 58, 58, 58
        ],
        [
          0, 0, 0, 0, 0, 0, 0, 0, 0, 0,
          0, 0, 0, 0, 0, 0, 0, 0, 0, 0,
          0, 0, 0, 0, 0, 0, 0, 0, 0, 0,
          0, 0, 0, 0, 0, 0, 0, 0, 0, 0,
          0, 0, 0, 0, 0, 0, 0, 0, 0, 0,
          0, 0, 0, 0, 0, 0, 0, 0, 0, 0,
          0, 0, 0, 0, 0, 0, 0, 0, 0, 0,
          0, 0, 0, 0, 0, 0, 0, 0, 0, 0,
          0, 0, 0, 0, 0, 0, 0, 0, 0, 0,
          0, 0, 0, 0, 0, 0, 0, 0, 0, 0
        ]
      ]
    }
  ]
}
