{
  "name": "Sample Map",
  "tileSetId": 0,
  "rooms": [
    {
      "tiles": [
        [
          55, 55, 55, 55, 55, 55, 55, 55, 55, 55,
          62, 62, 62, 62, 50, 62, 50, 62, 62, 62,
          58, 58, 58, 58, 50, 58, 50, 58, 58, 58,
          58, 58, 58, 58, 50, 58, 54, 58, 58, 58,
          48, 53, 58, 51, 48, 58, 62, 58, 58, 58,
          62, 63, 58, 61, 62, 58, 58, 58, 58, 58,
          58, 58, 58, 58, 58, 58, 58, 58, 58, 58,
          58, 58, 49, 58, 58, 58, 58, 58, 58, 58,
          58, 58, 50, 58, 58, 58, 58, 58, 58, 58,
          60, 60, 0, 60, 60, 60, 60, 60, 60, 60
        ],
        [
          0, 0, 0, 0, 0, 0, 0, 0, 0, 0,
          0, 0, 0, 0, 0, 0, 0, 0, 0, 0,
          0, 0, 0, 0, 0, 0, 0, 0, 0, 0,
          0, 0, 0, 0, 0, 0, 0, 0, 0, 0,
          0, 0, 0, 0, 0, 0, 0, 0, 0, 0,
          0, 0, 0, 0, 0, 0, 0, 0, 0, 0,
          0, 0, 0, 0, 0, 0, 0, 0, 0, 0,
          0, 0, 0, 0, 0, 0, 0, 0, 0, 0,
          0, 0, 0, 0, 0, 0, 0, 0, 0, 0,
          0, 0, 0, 0, 0, 0, 0, 0, 0, 0
        ]
      ]
    }
  ]
}
