{
  "name": "Sample Map",
  "tileSetId": 0,
  "rooms": [
    {
      "tiles": [
        [
          31, 31, 31, 31, 33, 31, 33, 31, 31, 31,
          4, 4, 4, 4, 26, 4, 26, 4, 4, 4,
          1, 1, 1, 1, 26, 12, 26, 23, 23,23,
          1, 1, 1, 1, 26, 1, 30, 23, 23, 23,
          24, 29, 1, 27, 34, 1, 4, 23, 23, 23,
          4, 5, 1, 3, 5, 1, 1, 23, 23, 23,
          1, 1, 1, 1, 1, 1, 1, 23, 23, 23,
          6, 7, 25, 1, 1, 1, 1, 23, 23, 23,
          14, 15, 26, 8, 9, 10, 1, 23, 23, 23,
          2, 2, 35, 2, 2, 2, 2, 2, 2, 2
        ],
        [
          0, 0, 0, 0, 0, 0, 0, 0, 0, 0,
          1, 16, 0, 2, 0, 7, 0, 0, 0, 11,
          9, 0, 8, 10, 0, 15, 0, 0, 0, 19,
          0, 0, 0, 0, 0, 0, 0, 0, 4, 0,
          0, 0, 0, 0, 0, 0, 0, 0, 12, 0,
          0, 0, 0, 0, 0, 0, 0, 0, 0, 0,
          0, 0, 0, 0, 0, 0, 0, 21, 22, 23,
          0, 0, 0, 0, 0, 0, 0, 29, 30, 31,
          0, 0, 0, 0, 0, 0, 0, 0, 0, 0,
          0, 0, 0, 0, 24, 25, 26, 0, 0, 0
        ]
      ]
    }
  ]
}
