{
  "name": "Sample Map",
  "rooms": [
    {
      "tiles": [
        58, 58, 58, 58, 58, 58, 58, 58, 58, 58,
        58, 58, 58, 58, 58, 58, 58, 58, 58, 58,
        58, 58, 58, 58, 58, 58, 58, 58, 58, 58,
        58, 58, 58, 58, 58, 58, 58, 58, 58, 58,
        58, 58, 58, 58, 58, 58, 58, 58, 58, 58,
        58, 58, 58, 58, 58, 58, 58, 58, 58, 58,
        58, 58, 58, 58, 58, 58, 58, 58, 58, 58,
        58, 58, 58, 58, 58, 58, 58, 58, 58, 58,
        58, 58, 58, 58, 58, 58, 58, 58, 58, 58,
        58, 58, 58, 58, 58, 58, 58, 58, 58, 58
      ]
    },
    {
      "tiles": [
        0, 0, 0, 0, 0, 0, 0, 0, 0, 0,
        0, 0, 0, 0, 0, 0, 0, 0, 0, 0,
        0, 0, 0, 0, 0, 0, 0, 0, 0, 0,
        0, 0, 0, 0, 0, 0, 0, 0, 0, 0,
        0, 0, 0, 0, 0, 0, 0, 0, 0, 0,
        0, 0, 0, 0, 0, 0, 0, 0, 0, 0,
        0, 0, 0, 0, 0, 0, 0, 0, 0, 0,
        0, 0, 0, 0, 0, 0, 0, 0, 0, 0,
        0, 0, 0, 0, 0, 0, 0, 0, 0, 0,
        0, 0, 0, 0, 0, 0, 0, 0, 0, 0
      ]
    },
    {
      "tiles": [
        0, 0, 0, 0, 0, 0, 0, 0, 0, 0,
        0, 0, 0, 0, 0, 0, 0, 0, 0, 0,
        0, 0, 0, 0, 0, 0, 0, 0, 0, 0,
        0, 0, 0, 0, 0, 0, 0, 0, 0, 0,
        0, 0, 0, 0, 0, 0, 0, 0, 0, 0,
        0, 0, 0, 0, 0, 0, 0, 0, 0, 0,
        0, 0, 0, 0, 0, 0, 0, 0, 0, 0,
        0, 0, 0, 0, 0, 0, 0, 0, 0, 0,
        0, 0, 0, 0, 0, 0, 0, 0, 0, 0,
        0, 0, 0, 0, 0, 0, 0, 0, 0, 0
      ]
    }
  ]
}
