{
  "name": "Sample Map",
  "tileSetId": 0,
  "rooms": [
    {
      "tiles": [
        [
          24, 24, 24, 24, 33, 24, 33, 24, 24, 24,
          4, 4, 4, 4, 26, 4, 26, 4, 4, 4,
          1, 1, 1, 1, 26, 1, 26, 23, 23,23,
          1, 1, 1, 1, 26, 1, 30, 23, 23, 23,
          24, 29, 1, 27, 34, 1, 4, 23, 23, 23,
          4, 5, 1, 3, 5, 1, 1, 23, 23, 23,
          1, 1, 1, 1, 1, 1, 1, 23, 23, 23,
          1, 1, 25, 1, 1, 1, 1, 23, 23, 23,
          1, 1, 26, 1, 1, 1, 1, 23, 23, 23,
          2, 2, 35, 2, 2, 2, 2, 2, 2, 2
        ],
        [
          0, 0, 0, 0, 0, 0, 0, 0, 0, 0,
          0, 0, 0, 0, 0, 0, 0, 0, 0, 0,
          0, 0, 0, 0, 0, 0, 0, 0, 0, 0,
          0, 0, 0, 0, 0, 0, 0, 0, 0, 0,
          0, 0, 0, 0, 0, 0, 0, 0, 0, 0,
          0, 0, 0, 0, 0, 0, 0, 0, 0, 0,
          0, 0, 0, 0, 0, 0, 0, 0, 0, 0,
          0, 0, 0, 0, 0, 0, 0, 0, 0, 0,
          0, 0, 0, 0, 0, 0, 0, 0, 0, 0,
          0, 0, 0, 0, 0, 0, 0, 0, 0, 0
        ]
      ]
    }
  ]
}
